12 15
XXXXXXXXXXXXXXX
X|-----------|X
X|-|||||||||-|X
X|-|---|---|-|X
X|-|-|||||-|-|X
X|-|-|-|-|-|-|X
X|-|.|.|.|.|-|X
X|-+-+-+-+-+-|X
X|.|-|||||-|.|X
X|-|---|---|-|X
X|||||||||||||X
XXXXXXXXXXXXXXX
8
H 7 1 S -
H 7 8 S |
B 7 5 N |
B 7 7 S +
A 10 10 S |
A 10 8 S |
C 13 1 S |
T 1 1 S |
